E,W,SE,SE,SW,W
E,NE,S,NE,SE,SW
S,E,SW,SE,SW,N
S,S,SW,NW,S,SW
NE,W,SE,E,NW,S
N,NW,NE,NW,E,G